R 800 500

NO ./textures/mossy.xpm
SO ./textures/redbrick.xpm
EA ./textures/greystone.xpm
WE ./textures/eagle.xpm
S   ./textures/pillar.xpm

F 223,189,77
C 135,206,250

    1111111111111111            
1111100000000011111111111
1000000000002000000000001
1000000000000000000000001
1000000000000200000000001
1111111111000000000000001
1200000000000000000000001
1000000000000000000000001 11111111
1000011111111111111111111110000021
1000000000111000000000001110000001
1000000000111000000000011100000011
1000000000000000000000001110000001
1200000000000000000000021110000001
1111111111111110000000001110000001
              10000000001110111111
              100000E0000110000001
              11111111100110000001
                      100000020001
                      100000000001
                      101111111111
                      111
